####################
#....#G  ......... #
#.....   ......... #
#....#   ......... #
#....#   ......... #
#....### ......... #
#....# # ......... #
#....# # ......... #
#P   # #          G#
#....# # ......... #
#....# # ......... #
#....### ......... #
#....#   ......... #
#....#   ......... #
#....#   ......... #
#....#   ......... #
#....#G  ......... #
####################
